##B     #
## #### #
#  #    #
# ## ####
     ####
A########
